42222222224P4P42222222224
3111111111113111111111113
3142241422413142241422413  
3130031300313130031300313
3142241422413142241422413
3111111111113111111111113
3122221312224222131222213
3111111311113111131111113
4222241422203022241422224
0000031300000000031300000
2222241304222224031422222
P00000110300000301100000P
2222241304222224031422222
0000031300000000031000000
4222241302224222031422224
3111111111113111111111113
3122241222213122221422213
3111131111111111111311113
4222131312222222131312224
3111111311111111131111113
3122222422213122242222213
3111111111113111111111113
42222222224P4P42222222224